00000000000000000000000000000000000000000000000000
00000000000000000000000000000000000000000000000000
00000000000000000000000000000000000000000000000000
00000000000111000000000000000000000000000000000000
00000000000111000000000000000000000000000000000000
00000000000111000000000000000000000000000000000000
00000000001110000000000000000000000000000000000000
00000000011100000000000000000000000000000000000000
00000000011100000000000000000000000000000000000000
00000000111000000000000000000000000000000000000000
00000000111000000000010000000000000000000000000000
00000000111001010000111000000000000000000000000000
00000000011111111101111100000000000000000000000000
00000000001111111111111100000000000000000000000000
00000000000110101111011100000000000000000000000000
00000000000000000010011100000000000000000000000000
00000000000000000000011100000000000000000000000000
00000000000000000000001110000000000000000000000000
00000000000000000000001110000000000000000000000000
00000000000000000000011100000000000000000000000000
00000000000000000000001110000000000000000000000000
00000000000000000000000111000000000000000000000000
00000000000000000000000011100000000000000000000000
00000000000000000000000011000000000000000000000000
00000000000000000000000010000000000000000000000000
00000000000000000000000000000000000000000000000000
00000000000000000000000000000000000000000000000000
00000000000000000000000000000000000000000000000000
00000000000000000000000000000000000000000000000000
00000000000000000000000000000000000000000000000000
00000000000000000000000000000000000000000000000000
00000000000000000000000000000000000111000000000000
00000000000000000000000000000000000011100000000000
00000000000000000000000000000000000011100000000000
00000000000000000000000000000000000011100000000000
00000000000000000000000000000000000001110000000000
00000000000000000001110000000000000011100000000000
00000001110000000000111000000000000011100000000000
00000001110000000000111000000000000111000000000000
00000011100000000001110000000000011011100000000000
00000011100000000000111000111111111111100000000000
00000011100000000001110000111111111111000000000000
00000001110000000001110000111111100110000000000000
00000011100000000011100001111100000000000000000000
00000111000000000001110011101110000000000000000000
10110111000000000011111011100111000000000000000000
11111111000000000001111101110111000000000000001001
11111110000000000000111111111111000000000000011111
01001100000000000000000111111110000000000000111111
00000000000000000000000011111111000000000001110110
