00000000000000000000000000000000000000000000000000
00000000000000000000000000000000000000000000000000
20000000000000000000000000000000000000000000000002
20000111111111111111111111111111111111111100000002
20000100000000000000000011000000000000000110000002
20000100000000000000000001100000000000000011000002
20000100000000000000000000110000000000000001100002
20000100000000000000000000011000000000000000100002
20000100000000000000000000001100000000000000100002
20000100000000000000000000000111111111111111100002
20000100000000000000000000000100000010000000000002
20000100000000000000000000000100000011000000000002
20000100000000000000000000000100000001100000000002
20000100000000000000000000000100000000110000000002
20000100000000000000000000000100000000011111110002
20000100000000000000000000000100000000000000000002
20000111111111111111111111111100000000000000000002
20000100000000000000000000000110000000000000000002
20000100000000000000000000000011000000000011000002
20000100000000000000000000000001100000000010000002
20000110000000000000000000000000110000000010000002
20000011000000000000000000000000011000000010000002
20000001100000000000000000000000001100000010000002
20000000111111111000000000000011111111111110000002
20000000000000001000001111111110000000000000000002
20000000000000001000011000001100000000000000000002
20000000000000001000110000001000000000000000000002
20000000000000001001100000001000000000000000000002
20000000000000001011000000001000000000000000000002
20000000000000001110000000001100000000000000000002
20000011111111111000000000000111110000000000000002
20000010000000000000000000000000010000000000000002
20000010000000000000000000000000010000000000000002
20000010000000000000000000000000010000000000000002
20000011111111111111111111111111110000000000000002
20000000001100000000000000000000010000000000000002
20000000011000000000000000000000011100000000000002
20000000110000000000000000000000010110000000000002
20000001100000000000000000000000010011000000000002
20000011000000000000000000000000000001100000000002
20000010000000000000000000000000000000110000000002
20000010000000000000000000000000000000011000000002
20000010000000000000000000000000000000001100000002
20000010000000000000000000000000000000000110000002
20000010000000000000000000000000000000000010000002
20000010000000000000000000000000000000000010000002
20000010000000000000110000000000000000000010000002
20000011111111111111111111111111111111111110000002
20000000000000000000000000000000000000000000000002
22222222222222222222222222222222222222222222222222
